Maze 1 - Very Easy

maze = [
    [0,0,0,0,0],
    [1,1,1,1,0],
    [0,0,0,1,0],
    [0,1,0,0,0],
    [0,1,1,1,0]
    ]

start = (0,0)
end = (4,4)

Maze 2 - Easy

maze = [
    [0,0,1,0,0],
    [0,0,1,0,1],
    [1,0,0,0,1],
    [1,1,1,0,0],
    [0,0,0,1,0]
    ]

start = (0,0)
end = (4,4)

Maze 3 = Easy+

maze = [
    [0,0,1,0,0,0],
    [0,0,1,0,1,0],
    [1,0,0,0,1,0],
    [1,1,1,0,0,0],
    [0,0,0,1,1,0],
    [0,1,0,0,0,0]
    ]

start = (0,0)
end = (5,5)

Maze 4 = Medium

maze = [
    [0,1,0,0,0,0,0],
    [0,1,0,1,1,1,0],
    [0,0,0,1,0,0,0],
    [1,1,0,1,0,1,0],
    [0,0,0,0,0,1,0],
    [0,1,1,1,0,1,0],
    [0,0,0,1,0,0,0]
    ]

start = (0,0)
end = (6,6)

Maze 5 - Medium+

maze = [
    [0,0,1,0,0,0,1,0],
    [0,0,1,0,1,0,1,0],
    [1,0,0,0,1,0,0,0],
    [1,1,1,0,0,0,1,0],
    [0,0,0,0,1,0,1,0],
    [0,1,1,1,0,0,1,0],
    [0,0,0,1,0,1,0,0],
    [1,1,0,0,0,1,0,0]
    ]

start = (0,0)
end = (7,7)

Maze 6 - Medium Hard

maze = [
    [0,0,1,0,0,0,1,0,0],
    [0,0,1,0,1,0,1,0,1],
    [1,0,0,0,1,0,0,0,1],
    [1,1,1,0,0,0,1,0,0],
    [0,0,0,0,1,0,1,1,0],
    [0,1,1,1,0,0,1,0,0],
    [0,0,0,1,0,1,0,0,1],
    [1,1,0,0,0,1,0,1,0],
    [0,0,0,1,0,0,0,0,0]
]

start = (0,0)
end = (8,8)

Maze 7 - Hard

maze = [
    [0,0,1,0,0,0,1,0,0,0,0],
    [0,0,1,0,1,0,1,0,1,0,1],
    [1,0,0,0,1,0,0,0,1,0,0],
    [1,1,1,0,0,0,1,0,0,0,1],
    [0,0,0,0,1,0,1,1,0,1,0],
    [0,1,1,1,0,0,1,0,0,0,0],
    [0,0,0,1,0,1,0,0,1,0,0],
    [1,1,0,0,0,1,0,1,0,0,0],
    [0,0,0,1,0,0,0,0,1,0,1],
    [1,1,0,0,0,1,1,0,0,0,0],
    [0,0,0,1,0,0,0,0,1,0,0]
    ]

start = (0,0)
end = (10,10)

Maze 8 - Hard+

maze = [
    [0,0,1,0,0,0,1,0,0,0,0],
    [0,0,1,0,1,0,1,0,1,0,1],
    [1,0,0,0,1,0,0,0,1,0,0],
    [1,1,1,0,0,0,1,0,0,0,1],
    [0,0,0,0,1,0,1,1,0,1,0],
    [0,1,1,1,0,0,1,0,0,0,0],
    [0,0,0,1,0,1,0,0,1,0,0],
    [1,1,0,0,0,1,0,1,0,0,0],
    [0,0,0,1,0,0,0,0,1,0,1],
    [1,1,0,0,0,1,1,0,0,0,0],
    [0,0,0,1,0,0,0,0,1,0,0]
    ]

start = (0,0)
end = (10,10)

Maze 9 - Very Hard

maze = [
    [0,0,1,0,0,0,1,0,0,0,0,0],
    [0,0,1,0,1,0,1,0,1,0,1,0],
    [1,0,0,0,1,0,0,0,1,0,0,0],
    [1,1,1,0,0,0,1,0,0,0,1,0],
    [0,0,0,0,1,0,1,1,0,1,0,0],
    [0,1,1,1,0,0,1,0,0,0,0,1],
    [0,0,0,1,0,1,0,0,1,0,0,0],
    [1,1,0,0,0,1,0,1,0,0,0,1],
    [0,0,0,1,0,0,0,0,1,0,1,0],
    [1,1,0,0,0,1,1,0,0,0,0,0],
    [0,0,0,1,0,0,0,0,1,0,0,1],
    [0,1,0,0,0,1,0,0,0,0,0,0]
    ]

start = (0,0)
end = (11,11)

Maze 10 - Extreme

maze = [
    [0,0,1,0,0,0,1,0,0,0,0,1,0,0,0],
    [0,0,1,0,1,0,1,0,1,0,1,0,1,0,1],
    [1,0,0,0,1,0,0,0,1,0,0,0,1,0,0],
    [1,1,1,0,0,0,1,0,0,0,1,0,0,0,1],
    [0,0,0,0,1,0,1,1,0,1,0,0,1,0,0],
    [0,1,1,1,0,0,1,0,0,0,0,1,0,0,0],
    [0,0,0,1,0,1,0,0,1,0,0,0,1,0,0],
    [1,1,0,0,0,1,0,1,0,0,0,1,0,0,1],
    [0,0,0,1,0,0,0,0,1,0,1,0,0,1,0],
    [1,1,0,0,0,1,1,0,0,0,0,0,1,0,0],
    [0,0,0,1,0,0,0,0,1,0,0,1,0,0,1],
    [1,0,1,0,0,1,0,0,0,1,0,0,0,1,0],
    [0,0,0,1,0,0,0,1,0,0,0,1,0,0,0],
    [1,1,0,0,0,1,0,0,0,1,0,0,1,0,0],
    [0,0,0,1,0,0,0,0,1,0,0,0,0,0,0]
    ]

start = (0,0)
end = (14,14)